Puttering along on your way to work at the asteroid mines, you recieve a distress signal.
Being the brave heroic soul that you are, you set course for the signal. As  you come across the space hulk floating through the asteroid field  the airlock beckons and you connect.

Xenocide
A space horror by William Pacini and Brian Gabin
Release 1 / Serial number 130316 / Inform 7 build 6G60 (I6/v6.32 lib 6/12N) SD

Mining Vessel
It's a small two seat mining ship that you've lovingly named "Ol" Faithful" after years of service. The Space Hulk that the distress signal came from sits AFT of the little vessel. If things go poorly, it may be your only means of escape.

You can see an Airlock here.

>radio 6232
(on Short-range Radio)

You successfully connect with someone on the other end of the radio.

>hello
(addressing the Doctor)
"Hello? Is anyone on this frequency?", you ask.
After a few silent seconds a man responds ecstatically, "Hello!? Who's this? Are you a survivor or a rescuer?"
"I'm a miner who responded to this ship's distress beacon and then got trapped on here by your coward captain." you explain.
"I'm not surprised. I'm the ship's medical professional. I've been trapped in the med bay ever since those things attacked." said the Doctor.

(You could ask him about himself or what happened.)

>ask about what happened
"I've seen some seriously messed up shit on here. What the hell happened here?", you ask.
"It happened so quickly. I had just come up here to gather some medical charts when the screaming began below. Most of the crew was having the lunch being served in the Galley when the aliens began pouring in the from the lower level. The Captain initiated the lockdown on the Galley locking nearly all of the crew in with those monsters. I've been trapped back in the med bay since.

>ask about aliens
"What can you tell me about the aliens?", you inquire.
Taking a deep breath the Doctor explains, "I got locked in the medical bay before just as they began to make their way into the Galley so I didn't get to see much of them. I can tell you that those bastards have utterly destroyed the Galley and killed everyone they've run into. I certain they know I'm in here. They spent hours attacking the blastdoors before giving up, it may only be a matter of time before they try and again and make it in."

>ask about captain
Though it may sound like the Doctor is standing right next to you, he is not.

>ask about Captain
Though it may sound like the Doctor is standing right next to you, he is not.

>ask about brig
Though it may sound like the Doctor is standing right next to you, he is not.

>ask about the brig
Though it may sound like the Doctor is standing right next to you, he is not.

>aft
(first ending your conversation with the Doctor)
(first opening the Airlock)
As you pass though the airlock into the Entry Commons, you hear a loud "Slam!" from behind. Wheeling on the spot, you realize to your horrors that the blast doors have sealed you in, for seemingly no reason. After about fifteen seconds, you hear a man's voice. 

 "Hello there, do not be alarmed."

 The  sound is coming from an intercom in the corner of the room. 

 "I've only blocked off your passage because I'm a desperate man, who's been cooped up in this floating prison for far too long. I promise that if you can get me out I'll let you go. I'm directly above you in the Bridge but in order to get here, you'll need to restore the power to certain parts of the ship and get the elevator working. I'll try to keep you updated as best as possible, but communication is a bit spotty. Time is of the essence, I'll be waiting." 

 With that the intercom cuts off and the room returns to an eerie silence.

"Are you still there?" Conserve your radio's power and disconnect it."

>aft
(first opening the Galley's Fore Blastdoor)
It seems to be locked.

>aft
(first opening the Galley's Fore Blastdoor)
It seems to be locked.

>look Galley's Fore Blastdoor
The port hole window is fogged up, but when you rub it off, you can faintly make out a bit of movement in the background. Just as you lean in, a tentacle moves up over the window and the other side begins to glaze over.

The window is completely blocked on the other side , but it reads "Galley" on the top.

>look airlock
A small bisected tube with a decompression chamber in the middle and large air tight blast doors seperateing the sections. You've seen hundreds of these before and can move right through without much hassle.

"Are you still there?" Conserve your radio's power and disconnect it."

>disconnect
(Short-range Radio)
You're not communicating with anyone.

>port
Hallway
A large passage  running along the port exterior of the ship. The monitors that line the outer wall simulate windows, and outside you can see the deserted asteroid field that you've been mining your whole life pass by. A line of small trees run along the monitors. 
 
 There are three exits out of the Hallway towards the AFT of the ship you see a sign labeled Barracks. Towards the  FORE of the ship the sign reads entry commons. and about halfway down on the starboard you see a sign reading elevator, but where the elevator should be, there is a rather large pile of rubble.

"Are you still there?" Conserve your radio's power and disconnect it."

>disconnect
(Short-range Radio)
You're not communicating with anyone.

* * *

>hello
(addressing the Doctor)
"Hello? Is anyone on this frequency?", you ask.
After a few silent seconds a man responds ecstatically, "Hello!? Who's this? Are you a survivor or a rescuer?"
"I'm a miner who responded to this ship's distress beacon and then got trapped on here by your coward captain." you explain.
"I'm not surprised. I'm the ship's medical professional. I've been trapped in the med bay ever since those things attacked." said the Doctor.

(You could ask him about himself or what happened.)

>ask about himself
Though it may sound like the Doctor is standing right next to you, he is not.

* * *

>aft
(first opening the Airlock)
As you pass though the airlock into the Entry Commons, you hear a loud "Slam!" from behind. Wheeling on the spot, you realize to your horrors that the blast doors have sealed you in, for seemingly no reason. After about fifteen seconds, you hear a man's voice. 

 "Hello there, do not be alarmed."

 The  sound is coming from an intercom in the corner of the room. 

 "I've only blocked off your passage because I'm a desperate man, who's been cooped up in this floating prison for far too long. I promise that if you can get me out I'll let you go. I'm directly above you in the Bridge but in order to get here, you'll need to restore the power to certain parts of the ship and get the elevator working. I'll try to keep you updated as best as possible, but communication is a bit spotty. Time is of the essence, I'll be waiting." 

 With that the intercom cuts off and the room returns to an eerie silence.

>aft
(first opening the Galley's Fore Blastdoor)
It seems to be locked.

>port
Hallway
A large passage  running along the port exterior of the ship. The monitors that line the outer wall simulate windows, and outside you can see the deserted asteroid field that you've been mining your whole life pass by. A line of small trees run along the monitors. 
 
 There are three exits out of the Hallway towards the AFT of the ship you see a sign labeled Barracks. Towards the  FORE of the ship the sign reads entry commons. and about halfway down on the starboard you see a sign reading elevator, but where the elevator should be, there is a rather large pile of rubble.

>aft
Barracks
As you exit the hallway, a foul stench gets caught in your nose, reeking of waste and decay. After a moment's hesitation you remember that the way behind is blocked. You gather your courage and taking a deep breath enter the barracks. 

Its clear that a Line of bunks ran down the  fore and aft side walls, but now they and the tatters that once were the sheets are strewn about the room.  Broken shards of furniture are smashed up against the walls and piled in the corners. But worst of all is the bodies. Your rough count is about fifteen dead men, but the limbs make it hard to be sure.

You can see a Galley's Aft Blastdoor and Pvt Wormund Journal Entry here.

>down
You can't go that way.

>aft
Officer's Quarters
The Officer's Quarters is in disarray. The  furniture has alll been shoved into the corner revealing the emergency ladder  that goes up and down. There are signs of struggle in hear and a bit a blood, 

You can see Sgt Castle's Journal Entry here.

>fown
That's not a verb I recognise.

>down
Engine Room
You emerge from the ladder's narrow passage into the Engine Room.

Boilers, pipes, and gauges crisscross the Engine Room. In the back sits the massive Power Generator. On the front of the Power Generator a console reads the error code...

You can see a generator2 here.

* * *

>starboard
Crew's Quarters
The Crew's Quarter's seems to be a bit of a sty, but is nothing compared to the massacre you just came from. There are no body parts anywhere, just a some ruffled up papers and unmade beds.

 The furniture is realtively intact with four bunks, one on each wall accompanied by a desk and a footlocker. The Engineer's footlocker seems to be the only one you can get into.

You can see Engineer's Desk (on which is Engineer's Manual) here.

>take manual
Taken.

>lookup 2131
You know what to do now.

* * *

>aft
Officer's Quarters
The Officer's Quarters is in disarray. The  furniture has alll been shoved into the corner revealing the emergency ladder  that goes up and down. There are signs of struggle in hear and a bit a blood, 

You can see Sgt Castle's Journal Entry here.

>down
Engine Room
You emerge from the ladder's narrow passage into the Engine Room.

Boilers, pipes, and gauges crisscross the Engine Room. In the back sits the massive Power Generator. On the front of the Power Generator a console reads the error code...

You can see Power Console here.

>fore
Armory
Racks of Aussault Rifles fill the locked safe and crates upon crates of ammunition are stacked up against the walls.  ts a damn shame they weren't expecting to use any before they got planetside.

You can see a Brig's Blastdoor, a gun safe (closed) and a multi-tool here.

>take multi-tool
Taken.

>drop tool
You can't see any such thing.

>aft
Engine Room
Boilers, pipes, and gauges crisscross the Engine Room. In the back sits the massive Power Generator. On the front of the Power Generator a console reads the error code...

You can see Power Console here.

>up
Officer's Quarters
The Officer's Quarters is in disarray. The  furniture has alll been shoved into the corner revealing the emergency ladder  that goes up and down. There are signs of struggle in hear and a bit a blood, 

You can see Sgt Castle's Journal Entry here.

>up
Weapons Systems Room
The exterior weapons systems are controlled from in this room. The manual override stations look dusty and unused. All the weapons systems in the world don't do a lick of good if your guns can't point the right way. A rack of Dominion Astral Torpedos sit in the corner ready to be loaded into the pipes. In the corner sits the nuclear warhead, saved for the biggest of targets.

* * *

>port
Hallway
A large passage  running along the port exterior of the ship. The monitors that line the outer wall simulate windows, and outside you can see the deserted asteroid field that you've been mining your whole life pass by. A line of small trees run along the monitors. 
 
 There are three exits out of the Hallway towards the AFT of the ship you see a sign labeled Barracks. Towards the  FORE of the ship the sign reads entry commons. and about halfway down on the starboard you see a sign reading elevator, but where the elevator should be, there is a rather large pile of rubble.

>starboard
Elevator
Elevator description

>up
The door closes and the elevator churns upwards to the top level.

>starboard
Observation Deck
In the center of the Observation Deck you can see down through a safety glass panel into the center of the Galley.  Most of the viewing port has been covered in the phlegmish substance, but through the direct center you can see about ten square feet of the Galley floor.The furniture seems to be haphazardly spread out and the carnage similar to the Barracks. The top floor itself seems to have been untouched by the incident.

You can see a Bridge's Blastdoor here.

>fore
(first opening the Bridge's Blastdoor)
It seems to be locked.

* * *

>aft
(first opening the Galley's Fore Blastdoor)
It seems to be locked.

>por
That's not a verb I recognise.

>aft
(first opening the Galley's Fore Blastdoor)
It seems to be locked.

* * *

>starboard
Elevator
Elevator description

>starboard
Galley
The room has been torn to pieces. This is where the creatures had been quarantined in their bulk after the accident. The tables and chairs have been ripped up and replaced with a floor covered by half devoured bodies and feces. One of the aliens seems a bit odd and is sprawled out in the center of the room on the last remaining table of the Dining Hall.

You can see a Galley's Starboard Blastdoor, a Galley's Fore Blastdoor, a Galley's Aft Blastdoor and an alien (on which is a pair of dog tags) here.

>look
Galley
The room has been torn to pieces. This is where the creatures had been quarantined in their bulk after the accident. The tables and chairs have been ripped up and replaced with a floor covered by half devoured bodies and feces. One of the aliens seems a bit odd and is sprawled out in the center of the room on the last remaining table of the Dining Hall.

You can see a Galley's Starboard Blastdoor, a Galley's Fore Blastdoor, a Galley's Aft Blastdoor and an alien (on which is a pair of dog tags) here.

>port
Elevator
Elevator description

>down
The door closes and the elevator churns upwards to the bottom level.

>starboard
Armory
Racks of Aussault Rifles fill the locked safe and crates upon crates of ammunition are stacked up against the walls.  Too bad it was all down here.

You can see a Brig's Blastdoor and a gun safe (closed) here.

>port
You can't go that way.

* * *

>port
Hallway
A large passage  running along the port exterior of the ship. The monitors that line the outer wall simulate windows, and outside you can see the deserted asteroid field that you've been mining your whole life pass by. A line of small trees run along the monitors. 
 
 There are three exits out of the Hallway towards the AFT of the ship you see a sign labeled Barracks. Towards the  FORE of the ship the sign reads entry commons. and about halfway down on the starboard you see a sign reading elevator, but where the elevator should be, there is a rather large pile of rubble.

* * *

>aft
Officer's Quarters
The Officer's Quarters is in disarray. The  furniture has alll been shoved into the corner revealing the emergency ladder  that goes up and down. There are signs of struggle in hear and a bit a blood, 

You can see Sgt Castle's Journal Entry here.

>down
Engine Room
You emerge from the ladder's narrow passage into the Engine Room.

Boilers, pipes, and gauges crisscross the Engine Room. In the back sits the massive Power Generator. On the front of the Power Generator a console reads the error code...

You can see a Power Console here.

>port
You can't go that way.

>fore
Armory
Racks of Aussault Rifles fill the locked safe and crates upon crates of ammunition are stacked up against the walls.  Too bad it was all down here.

You can see a Brig's Blastdoor and a gun safe (closed) here.

>port
You press the button to call the elevator and stand anxiously in the Armory listening to sounds of the creatures moving throughout the ship.

You can't go that way.

>port
You can't go that way.

* * *

>down
Engine Room
You emerge from the ladder's narrow passage into the Engine Room.

Boilers, pipes, and gauges crisscross the Engine Room. In the back sits the massive Power Generator. On the front of the Power Generator a console reads the error code...

You can see a Power Console here.

>fore
Armory
Racks of Aussault Rifles fill the locked safe and crates upon crates of ammunition are stacked up against the walls.  Too bad it was all down here.

You can see a Brig's Blastdoor and a gun safe (closed) here.

* * *

>port
You press the button to call the elevator and stand anxiously in the Armory listening to sounds of the creatures moving throughout the ship.

You can't go that way.

>look
Armory
Racks of Aussault Rifles fill the locked safe and crates upon crates of ammunition are stacked up against the walls.  Too bad it was all down here.

You can see a Brig's Blastdoor and a gun safe (closed) here.

>aft
Engine Room
Boilers, pipes, and gauges crisscross the Engine Room. In the back sits the massive Power Generator. On the front of the Power Generator a console reads the error code...

You can see a Power Console here.

>fore
Armory
Racks of Aussault Rifles fill the locked safe and crates upon crates of ammunition are stacked up against the walls.  Some good it did them.

You can see a Brig's Blastdoor and a gun safe (closed) here.

>port
You can't go that way.

>port
You can't go that way.

* * *

>port
You press the button to call the elevator and stand anxiously in the Armory listening to sounds of the creatures moving throughout the ship.

You can't go that way.

>prt
That's not a verb I recognise.

* * *

>potr
That's not a verb I recognise.

* * *

>look
Armory
Racks of Aussault Rifles fill the locked safe and crates upon crates of ammunition are stacked up against the walls.  Too bad it was all down here.

You can see a Brig's Blastdoor and a gun safe (closed) here.

* * *

>starboard
Crew's Quarters
The Crew's Quarter's seems to be a bit of a sty, but is nothing compared to the massacre you just came from. There are no body parts anywhere, just a some ruffled up papers and unmade beds.

 The furniture is realtively intact with four bunks, one on each wall accompanied by a desk and a footlocker. The Engineer's footlocker seems to be the only one you can get into.

You can see Engineer's Desk (on which is Engineer's Manual) here.

>starboard
You can't go that way.

>take manual
Taken.

>port
Barracks

Its clear that a Line of bunks ran down the  fore and aft side walls, but now they and the tatters that once were the sheets are strewn about the room.  Broken shards of furniture are smashed up against the walls and piled in the corners. But worst of all is the bodies. Your rough count is about fifteen dead men, but the limbs make it hard to be sure.

You can see a Galley's Aft Blastdoor and Pvt Wormund Journal Entry here.

>aft
Officer's Quarters
The Officer's Quarters is in disarray. The  furniture has alll been shoved into the corner revealing the emergency ladder  that goes up and down. There are signs of struggle in hear and a bit a blood, 

You can see Sgt Castle's Journal Entry here.

* * *

>down
Engine Room
You emerge from the ladder's narrow passage into the Engine Room.

Boilers, pipes, and gauges crisscross the Engine Room. In the back sits the massive Power Generator. On the front of the Power Generator a console reads the error code...

You can see a Power Console here.

>look
Engine Room
Boilers, pipes, and gauges crisscross the Engine Room. In the back sits the massive Power Generator. On the front of the Power Generator a console reads the error code...

You can see a Power Console here.

>look console
You see nothing special about the Power Console.

>look Power Console
You see nothing special about the Power Console.

* * *

>take manual
Taken.

>research Life Support Console
You can't see any such thing.

>port
Barracks

Its clear that a Line of bunks ran down the  fore and aft side walls, but now they and the tatters that once were the sheets are strewn about the room.  Broken shards of furniture are smashed up against the walls and piled in the corners. But worst of all is the bodies. Your rough count is about fifteen dead men, but the limbs make it hard to be sure.

You can see a Galley's Aft Blastdoor and Pvt Wormund Journal Entry here.

* * *

>down
Engine Room
You emerge from the ladder's narrow passage into the Engine Room.

Boilers, pipes, and gauges crisscross the Engine Room. In the back sits the massive Power Generator. On the front of the Power Generator a console reads the error code...

You can see Power Console here.

>fore
Armory
Racks of Aussault Rifles fill the locked safe and crates upon crates of ammunition are stacked up against the walls.  Some good it did them.

You can see a Brig's Blastdoor, a gun safe (closed) and a multi-tool here.

>fore
Life Support Systems
The room is remarkably dry. Almost mimicking a clean room. A series of dull pipes run between a few pumps. The pipes are labeled with the names of rooms they are going to. In the center is a console.

>research Life Support Systems
You can't see any such thing.

* * *

>take manual
Taken.

>research manual in manual
I didn't understand that number.

>research manual in manual
I didn't understand that number.

* * *

>port
Barracks

Its clear that a Line of bunks ran down the  fore and aft side walls, but now they and the tatters that once were the sheets are strewn about the room.  Broken shards of furniture are smashed up against the walls and piled in the corners. But worst of all is the bodies. Your rough count is about fifteen dead men, but the limbs make it hard to be sure.

You can see a Galley's Aft Blastdoor and Pvt Wormund Journal Entry here.

>down
You can't go that way.

>fore
(first opening the Galley's Aft Blastdoor)
It seems to be locked.

>aft
Officer's Quarters
The Officer's Quarters is in disarray. The  furniture has alll been shoved into the corner revealing the emergency ladder  that goes up and down. There are signs of struggle in hear and a bit a blood, 

You can see Sgt Castle's Journal Entry here.