SpaceInform
An Interactive Fiction by William Pacini and Brian Gabin
Release 1 / Serial number 130315 / Inform 7 build 6G60 (I6/v6.32 lib 6/12N) SD

Mining Vessel
It's a small two seat mining ship that you've lovingly named "Ol" Faithful" after years of service. It currently sits docked at the FORE of the Space Hulk that the distress signal came from. If things go poorly, it may be your only means of escape.

You can see an Airlock here.

>s
Cardinal directions don't make sense on a spaceship

>s
shit

>s
Galley
Galley description

>s
Barracks
Barracks description

>s
Officer's Quarters
Officer's Quarters description

>s
You can't go that way.

>up
Weapons Systems Room
Weapons Systems Room description

>n
Observation Deck

* * *

>s
Cardinal directions don't make sense on a spaceship

>aft
(first opening the Airlock)
As you pass though the airlock into the Entry Commons, you hear a loud "Slam!" from behind. Wheeling on the spot, you realize to your horrors that the blast doors have sealed you in, for seemingly no reason. After about fifteen seconds, you hear a man's voice. 

 "Hello there, do not be alarmed."

 The  sound is coming from an intercom in the corner of the room. 

 "I've only blocked off your passage because I'm a desperate man, who's been cooped up in this floating prison for far too long. I promise that if you can get me out I'll let you go. I'm directly above you in the Bridge but in order to get here, you'll need to restore the power to certain parts of the ship and get the elevator working. I'll try to keep you updated as best as possible, but communication is a bit spotty. Time is of the essence, I'll be waiting." 

 With that the intercom cuts off and the room returns to an eerie silence.

>aft
Entry Commons
Entry Commons description

>go port
Hallway
Hallway description

>go aft
Barracks
Barracks description

>go fore
Galley
Galley description

>fore
Entry Commons
Entry Commons description

>fore
Airlock
Air Lock description

* * *

>port
Hallway
A large passage  running along the port exterior of the ship. The monitors that line the outer wall simulate windows, and outside you can see the deserted asteroid field that you've been mining your whole life pass by. 
 
 There are three exits out of the Hallway towards the AFT of the ship you see a sign labeled Barracks. Towards the  FORE of the ship the sign reads entry commons. and about halfway down on the starboard you see a sign reading elevator, but where the elevator should be, there is a rather large pile of rubble.

>x trees
While providing no practical use, the trees give an aesthetic comfort to the crew members and soldiers that helps stave off the dreaded Cabin Fever.

* * *

>s
Cardinal directions don't make sense on a spaceship

>e
Cardinal directions don't make sense on a spaceship

>a
What do you want to a?

>s
There's no one here to talk to.

>e
Cardinal directions don't make sense on a spaceship

>s
Cardinal directions don't make sense on a spaceship

* * *

>e
Cardinal directions don't make sense on a spaceship

>n
Cardinal directions don't make sense on a spaceship

>ne
You can't go that way.

>nw
Cardinal directions don't make sense on a spaceship

* * *

SpaceInform
An Interactive Fiction by William Pacini and Brian Gabin
Release 1 / Serial number 130315 / Inform 7 build 6G60 (I6/v6.32 lib 6/12N) SD

Mining Vessel
It's a small two seat mining ship that you've lovingly named "Ol" Faithful" after years of service. It currently sits docked at the FORE of the Space Hulk that the distress signal came from. If things go poorly, it may be your only means of escape.

You can see an Airlock here.

>fore
You can't go that way.

>aft
That's not a verb I recognise.

>port
You can't go that way.

>starboard
That's not a verb I recognise.

* * *

SpaceInform
An Interactive Fiction by William Pacini and Brian Gabin
Release 1 / Serial number 130315 / Inform 7 build 6G60 (I6/v6.32 lib 6/12N) SD

Mining Vessel
It's a small two seat mining ship that you've lovingly named "Ol" Faithful" after years of service. It currently sits docked at the FORE of the Space Hulk that the distress signal came from. If things go poorly, it may be your only means of escape.

You can see an Airlock here.

>fore\
That's not a verb I recognise.

>fore
You can't go that way.

>aft
You can't go that way.

>starboard
You can't go that way.

>port
You can't go that way.

>e
You can't go that way.

>s
Airlock
Air Lock description

* * *

SpaceInform
An Interactive Fiction by William Pacini and Brian Gabin
Release 1 / Serial number 130315 / Inform 7 build 6G60 (I6/v6.32 lib 6/12N) SD

Mining Vessel
It's a small two seat mining ship that you've lovingly named "Ol" Faithful" after years of service. It currently sits docked at the FORE of the Space Hulk that the distress signal came from. If things go poorly, it may be your only means of escape.

You can see an Airlock here.

>look
Mining Vessel
Mining Vessel description

>aft
Airlock
Air Lock description

>aft
Entry Commons
Entry Commons description

>aft
Galley
Galley description

>aft
Barracks
Barracks description

>aft
Officer's Quarters
Officer's Quarters description

>aft
You can't go that way.

>fore
Barracks
Barracks description

>starboard
Crew's Quarters
Crew's Quarters description

>fore
Medical Bay
Medical Bay description

>port
Galley
Galley description

>port
Elevator
Elevator description

>port
Hallway
Hallway description

>aft
Barracks
Barracks description

>fore
Galley
Galley description

>port
Elevator
Elevator description

* * *

>port
Hallway
Hallway description

>port
You can't go that way.

>fore
Entry Commons
Entry Commons description

>aft
Galley
Galley description

>port
Elevator
Elevator description

>aft
You can't go that way.

>port
Hallway
Hallway description

* * *

>fore
Galley
Galley description

>for
That's not a verb I recognise.

>fore
Entry Commons
Entry Commons description

>port
Hallway
Hallway description

* * *

>port
You can't go that way.

>go back
You can't see any such thing.

>look
Hallway
Hallway description

>hellp
That's not a verb I recognise.

>hello
That's not a verb I recognise.

>hello
That's not a verb I recognise.

>Hello
That's not a verb I recognise.

* * *

SpaceInform
An Interactive Fiction by William Pacini and Brian Gabin
Release 1 / Serial number 130315 / Inform 7 build 6G60 (I6/v6.32 lib 6/12N) SD

Mining Vessel
It's a small two seat mining ship that you've lovingly named "Ol" Faithful" after years of service. It currently sits docked at the FORE of the Space Hulk that the distress signal came from. If things go poorly, it may be your only means of escape.

You can see an Airlock here.

>aft
(first opening the Airlock)
As you pass though the airlock into the Entry Commons, you hear a loud "Slam!" from behind. Wheeling on the spot, you realize to your horrors that the blast doors have sealed you in, for seemingly no reason. After about fifteen seconds, you hear a man's voice. 

 "Hello there, do not be alarmed."

 The  sound is coming from an intercom in the corner of the room. 

 "I've only blocked off your passage because I'm a desperate man, who's been cooped up in this floating prison for far too long. I promise that if you can get me out I'll let you go. I'm directly above you in the Bridge but in order to get here, you'll need to restore the power to certain parts of the ship and get the elevator working. I'll try to keep you updated as best as possible, but communication is a bit spotty. Time is of the essence, I'll be waiting." 

 With that the intercom cuts off and the room returns to an eerie silence.

>aft
Galley
Galley description

>aft
Galley
Galley description

* * *

>port
Elevator
Elevator description

>up
The door closes and the elevator churns upwards to the top level.

>up
You can't go that way.

>up
You can't go that way.

* * *

>up
The door closes and the elevator churns upwards to the top level.

>go up
You can't go that way.

* * *

>up
The door closes and the elevator churns upwards to the top level.

>starboard
Observation Deck
Observation Deck

>fore
Bridge
Bridge description

You can see a Captain here.

>hello captain
I only understood you as far as wanting to hello.

>hello
(addressing the Captain)
You say hello to the Captain.

You have nothing specific in mind to discuss with Captain right now.

* * *

>aft
Galley
Galley description

>af
That's not a verb I recognise.

>aft
Barracks
Barracks description

* * *

>fore
Barracks
Barracks description

>port
Hallway
Hallway description

* * *

>aft
Barracks
Barracks description

>starboard
Crew's Quarters
Crew's Quarters description

You can see Engineer's Manual here.

>l Engineer's Manual
The cover reads "The MonteCarlo Pathfinder Maintenance Manual" in big golden letters across the cover. Inside it seems to contain schematics for each of the ships integral systams. Sadly, the book seems to be worn and torn , clearly heavily used and not well taken care of.

* * *

>port
Elevator
Elevator description

>starboard
Elevator
Elevator description

* * *

>up
The door closes and the elevator churns upwards to the top level.

>up
The elevator is already on the top level.

* * *

>up
The door closes and the elevator churns upwards to the top level.

>port
You can't go that way.

>starboard
Observation Deck
Observation Deck